NO textures/north.xpm
SO textures/south.xpm
WE textures/west.xpm
EA textures/east.xpm

F 0,0,0
C 0,0,0

11111111111
11000000001
10000000001
10000000001
1000N000001
11111111111
