NO textures/north.xpm
SO textures/south.xpm
WE textures/west.xpm
EA textures/east.xpm

F 0,0,0
C 0,0,0

111111
100001
100001
100001
100N01
111111
